Job,Operation,Machine,Start,Processing Time,End
J25-0000,0,M00,2481,76,2557
J25-0000,1,M01,2594,69,2663
J25-0000,2,M03,2681,76,2757
J25-0000,3,M05,2783,51,2834
J25-0000,4,M02,2834,85,2919
J25-0000,5,M09,2970,11,2981
J25-0000,6,M06,3158,40,3198
J25-0000,7,M07,3220,89,3309
J25-0000,8,M04,3309,26,3335
J25-0000,9,M08,3586,74,3660
J25-0001,0,M01,1521,46,1567
J25-0001,1,M00,1567,37,1604
J25-0001,2,M03,1604,61,1665
J25-0001,3,M02,1665,13,1678
J25-0001,4,M06,1678,32,1710
J25-0001,5,M05,1710,21,1731
J25-0001,6,M09,1731,32,1763
J25-0001,7,M08,1763,89,1852
J25-0001,8,M07,1852,30,1882
J25-0001,9,M04,2283,55,2338
J25-0002,0,M00,2954,29,2983
J25-0002,1,M01,2983,78,3061
J25-0002,2,M02,3061,9,3070
J25-0002,3,M03,3079,36,3115
J25-0002,4,M04,3169,49,3218
J25-0002,5,M05,3218,11,3229
J25-0002,6,M06,3315,62,3377
J25-0002,7,M07,3377,56,3433
J25-0002,8,M08,3433,44,3477
J25-0002,9,M09,3723,21,3744
J25-0003,0,M01,2243,91,2334
J25-0003,1,M00,2349,85,2434
J25-0003,2,M03,2493,39,2532
J25-0003,3,M02,2545,74,2619
J25-0003,4,M08,2619,90,2709
J25-0003,5,M05,2709,10,2719
J25-0003,6,M07,2929,12,2941
J25-0003,7,M06,2981,89,3070
J25-0003,8,M09,3070,45,3115
J25-0003,9,M04,3346,33,3379
J25-0004,0,M01,3546,81,3627
J25-0004,1,M02,3627,95,3722
J25-0004,2,M00,3722,71,3793
J25-0004,3,M04,3793,99,3892
J25-0004,4,M06,3892,9,3901
J25-0004,5,M08,3901,52,3953
J25-0004,6,M07,3953,85,4038
J25-0004,7,M03,4038,98,4136
J25-0004,8,M09,4136,22,4158
J25-0004,9,M05,4813,43,4856
J25-0005,0,M00,2086,43,2129
J25-0005,1,M02,2129,90,2219
J25-0005,2,M04,2338,75,2413
J25-0005,3,M09,2413,11,2424
J25-0005,4,M03,2424,69,2493
J25-0005,5,M01,2544,28,2572
J25-0005,6,M06,2572,46,2618
J25-0005,7,M05,2655,46,2701
J25-0005,8,M07,2701,72,2773
J25-0005,9,M08,3076,30,3106
J25-0006,0,M01,2459,85,2544
J25-0006,1,M00,2678,13,2691
J25-0006,2,M02,2691,61,2752
J25-0006,3,M06,2752,7,2759
J25-0006,4,M08,2771,64,2835
J25-0006,5,M09,2894,76,2970
J25-0006,6,M05,2980,47,3027
J25-0006,7,M03,3027,52,3079
J25-0006,8,M04,3079,90,3169
J25-0006,9,M07,3494,45,3539
J25-0007,0,M02,1937,84,2021
J25-0007,1,M01,2021,2,2023
J25-0007,2,M05,2023,52,2075
J25-0007,3,M03,2087,95,2182
J25-0007,4,M08,2182,48,2230
J25-0007,5,M09,2230,72,2302
J25-0007,6,M00,2302,47,2349
J25-0007,7,M06,2349,65,2414
J25-0007,8,M04,2488,6,2494
J25-0007,9,M07,2904,25,2929
J25-0008,0,M02,2755,14,2769
J25-0008,1,M00,2769,6,2775
J25-0008,2,M01,2815,22,2837
J25-0008,3,M05,2919,61,2980
J25-0008,4,M03,2980,26,3006
J25-0008,5,M04,3006,69,3075
J25-0008,6,M08,3150,21,3171
J25-0008,7,M07,3171,49,3220
J25-0008,8,M09,3220,72,3292
J25-0008,9,M06,3488,53,3541
J25-0009,0,M02,2500,31,2531
J25-0009,1,M00,2563,86,2649
J25-0009,2,M01,2769,46,2815
J25-0009,3,M05,2834,74,2908
J25-0009,4,M04,2908,32,2940
J25-0009,5,M06,3070,88,3158
J25-0009,6,M08,3210,19,3229
J25-0009,7,M09,3345,48,3393
J25-0009,8,M07,3433,36,3469
J25-0009,9,M03,3499,79,3578
J25-0010,0,M00,2649,29,2678
J25-0010,1,M01,2691,78,2769
J25-0010,2,M02,2769,9,2778
J25-0010,3,M03,2778,36,2814
J25-0010,4,M04,2814,49,2863
J25-0010,5,M05,2908,11,2919
J25-0010,6,M06,2919,62,2981
J25-0010,7,M07,2981,56,3037
J25-0010,8,M08,3106,44,3150
J25-0010,9,M09,3324,21,3345
J25-0011,0,M00,2190,43,2233
J25-0011,1,M02,2233,90,2323
J25-0011,2,M04,2413,75,2488
J25-0011,3,M09,2488,11,2499
J25-0011,4,M03,2532,69,2601
J25-0011,5,M01,2663,28,2691
J25-0011,6,M06,2691,46,2737
J25-0011,7,M05,2737,46,2783
J25-0011,8,M07,2822,72,2894
J25-0011,9,M08,3180,30,3210
J25-0012,0,M01,3249,91,3340
J25-0012,1,M00,3340,85,3425
J25-0012,2,M03,3425,39,3464
J25-0012,3,M02,3464,74,3538
J25-0012,4,M08,3660,90,3750
J25-0012,5,M05,3750,10,3760
J25-0012,6,M07,3760,12,3772
J25-0012,7,M06,3772,89,3861
J25-0012,8,M09,3861,45,3906
J25-0012,9,M04,4352,33,4385
J25-0013,0,M01,1440,81,1521
J25-0013,1,M02,1521,95,1616
J25-0013,2,M00,1616,71,1687
J25-0013,3,M04,1687,99,1786
J25-0013,4,M06,1786,9,1795
J25-0013,5,M08,1852,52,1904
J25-0013,6,M07,1904,85,1989
J25-0013,7,M03,1989,98,2087
J25-0013,8,M09,2087,22,2109
J25-0013,9,M05,2524,43,2567
J25-0014,0,M02,2531,14,2545
J25-0014,1,M00,2557,6,2563
J25-0014,2,M01,2572,22,2594
J25-0014,3,M05,2594,61,2655
J25-0014,4,M03,2655,26,2681
J25-0014,5,M04,2681,69,2750
J25-0014,6,M08,2750,21,2771
J25-0014,7,M07,2773,49,2822
J25-0014,8,M09,2822,72,2894
J25-0014,9,M06,3262,53,3315
J25-0015,0,M02,2021,84,2105
J25-0015,1,M01,2105,2,2107
J25-0015,2,M05,2107,52,2159
J25-0015,3,M03,2182,95,2277
J25-0015,4,M08,2277,48,2325
J25-0015,5,M09,2325,72,2397
J25-0015,6,M00,2434,47,2481
J25-0015,7,M06,2481,65,2546
J25-0015,8,M04,2546,6,2552
J25-0015,9,M07,2956,25,2981
